111111111111111111111111111111111
110C00000CC0000000C000000C0000001
1000001000000000C0001000000000001
1000000100E0000000000110000000001
1000P0000000C1100010000CCC0000001
111111111111111111111111111111111